20
25
20 20 20 20 20 20 20 20 20 20 20 20 20 20 20 20 20 20 20 20 
20 20 4 4 4 4 20 20 21 1 1 1 1 1 1 1 1 21 21 20 
20 20 3 3 3 4 1 4 1 1 1 4 1 4 1 1 1 5 21 20 
20 20 3 3 3 4 1 1 4 1 1 1 1 1 1 1 1 1 1 20 
20 20 3 3 3 4 26 24 25 24 25 1 1 1 20 1 1 1 1 20 
20 20 4 4 4 4 26 6 6 6 26 1 1 6 20 6 2 1 1 20 
20 20 20 20 20 20 26 21 1 7 27 4 1 6 20 6 2 1 1 20 
20 1 1 1 1 1 26 6 1 22 26 1 1 6 20 6 2 1 1 20 
20 1 1 1 1 1 27 1 1 1 27 1 1 20 20 20 1 5 1 20 
20 24 25 24 25 24 25 1 1 1 27 23 1 1 1 1 1 1 1 20 
20 6 1 1 1 1 1 1 1 1 1 1 1 1 1 1 1 1 1 20 
20 1 1 1 1 4 1 1 5 1 1 1 1 4 1 1 1 1 7 20 
20 21 21 1 1 1 6 1 1 5 1 1 1 1 1 1 1 21 1 20 
20 21 21 4 1 1 1 1 1 1 1 1 1 7 1 1 21 21 21 20 
20 20 20 20 20 20 20 20 1 1 1 1 1 1 20 20 20 20 20 20 
30 30 30 31 30 31 30 31 30 8 9 30 30 31 30 30 31 31 30 30 
28 28 28 28 28 28 28 28 28 10 11 28 28 28 28 28 28 28 28 29 
20 23 1 1 1 1 4 1 22 1 1 23 1 1 1 20 4 1 6 20 
20 21 1 4 1 1 1 1 1 1 1 1 1 1 1 20 1 4 6 20 
20 6 1 1 1 1 1 1 1 1 1 1 1 1 1 20 1 1 1 20 
20 21 1 6 1 1 4 1 1 4 1 1 1 1 1 20 1 1 6 20 
20 21 4 1 1 1 1 1 1 1 1 1 1 1 1 1 1 1 1 20 
20 21 1 1 1 1 1 1 1 1 1 4 1 1 1 1 1 6 1 20 
20 6 1 20 1 4 22 23 1 1 1 1 1 6 1 20 23 6 1 20 
20 20 20 20 20 20 20 20 20 20 20 20 20 20 20 20 20 20 20 20 
